1111111111111
1001000000001
1000011111001
10001100N0001
111111      1111111